11111111111
1P0C0000001
10000100001
10001010C01
1CM10001MM1
100M1010001
1M00M1000E1
1MM00000001
11111111111