1111111111111
1001M000000C1
1000011111001
10C0000111P01
1000010111001
1000010011001
1000000001001
1E0111001C001
10C0010111001
1010010M11001
1101011011001
1000000011001
100011E000001
1111111111111