1111111111111
1MC100000M0C1
1M0001M00CM01
1P0CM1E000001
1111111111111
1101101000111
1101101111011
1110001000011
1111101011111
1111101100011
1111111111111
1111111111111