11111111111111111111111111111111111111111111111111
10010001100010000110001110000001111100000000110001
10100100001101000000010000001000000010011111000011
10000000000C001000C0001000010100100000000100010001
10100000000000100000000000000000101100001100000101
10C00000011000000000010010001100011010011001000001
100011C00C0101M011MM010000000001110100101000010001
101M0C101000000000001000000001C0010000000000000101
1M000000M000110000010100011001M0M11000000000010011
1M00C000M0000100100000010011100M000000000000000101
11000000M00110010001000010001001000000000100000001
10000101110000000001100010C0M000000001000000001101
1000000010C10010011010010101000000C001000000000011
1100010010000011C000010010000110010000001010001001
1000010000100000000C000001000010001010010110001001
10001C00001000010011100011010000011100M00111000001
10001001010000110101110101M00C00001000000010110001
10101E0111000000000000100011000000110P000001101001
10010MM0010000010000000000000000M10100000000010001
10100110C0M100000000C10000100001000010000CMC110111
100000000000M10010100010100000M0000000100010001001
110010010000110100100010000000M00001100M0001110001
10000100001M0001010001001101C001000000001000001001
10000000001100000000000100000100100000001000011001
11111111111111111111111111111111111111111111111111